{
    "first": {
        "width": 30,
        "height": 15,
        "map": [
            [[3], [3], [3], [3], [3], [3], [4], [4], [3], [3], [3], [3], [3], [3]],
            [[3], [1], [1], [1], [1], [1], [4], [4], [1], [1], [1], [1], [1], [3]],
            [[3], [1], [1], [1], [1], [1], [4], [4], [1], [1], [1], [1], [1], [3]],
            [[3], [1], [1], [1], [1], [1], [4], [4], [1], [1], [1], [1], [1], [3]],
            [[3], [1], [1], [1], [1], [1], [4], [4], [4], [1], [1], [1], [1], [3]],
            [[3], [1], [1], [1], [1], [1], [1], [4], [4], [1], [1], [1], [1], [3]],
            [[3], [1], [1], [1], [1], [1], [1], [4], [4], [1], [1], [1], [1], [3]],
            [[3], [1], [1], [1], [1], [1], [1], [4], [4], [4], [4], [4], [4], [3]],
            [[3], [1], [1], [1], [1], [1], [1], [4], [4], [4], [4], [4], [4], [3]],
            [[3], [1], [1], [1], [1], [1], [1], [4], [4], [1], [1], [1], [1], [3]],
            [[3], [1], [1], [2], [1], [1], [1], [1], [1], [1], [1], [1], [1], [3]],
            [[3], [1], [1], [2], [2], [1], [1], [1], [1], [1], [1], [1], [1], [3]],
            [[3], [1], [1], [1], [1], [1], [1], [1], [1], [1], [1], [1], [1], [3]],
            [[3], [1], [1], [1], [1], [1], [1], [1], [1], [1], [1], [1], [1], [3]],
            [[3], [3], [3], [3], [3], [3], [3], [3], [3], [3], [3], [3], [3], [3]]
        ]
    },
    "cave_1": {
        "width": 30,
        "height":15,
        "map": [
            [[3], [3], [3], [3], [3], [3], [3], [3], [3], [3], [3], [3], [3], [3]],
            [[3], [1], [1], [1], [1], [1], [1], [1], [1], [1], [1], [1], [1], [3]],
            [[3], [1], [1], [1], [1], [1], [1], [1], [1], [1], [1], [1], [1], [3]],
            [[3], [1], [1,6], [1], [1], [1], [1], [1], [1], [1], [1], [1], [1], [3]],
            [[3], [1], [1], [1], [1], [1], [1], [1], [1], [1], [1], [1], [1], [3]],
            [[3], [1], [1], [1], [1], [1], [1], [1], [1], [1], [1], [1], [1], [3]],
            [[3], [1], [1], [1], [1], [1], [1,8.1], [1,8.2], [1,8.3], [1,8.4], [1], [1], [1], [3]],
            [[3], [1], [1], [1], [1], [1], [1,8.5], [1,8.6], [1,8.7], [1,8.8], [1], [1], [1], [3]],
            [[3], [1], [1], [1], [1], [1], [1], [1], [1], [1], [1], [1], [1], [3]],
            [[3], [1], [1], [1], [1], [1], [1], [1], [1], [1], [1], [1], [1], [3]],
            [[3], [1], [1], [1], [1], [1], [1], [1], [1], [1], [1], [1], [1], [3]],
            [[3], [1], [1], [1], [1], [1], [1], [1], [1], [1], [1], [1], [1], [3]],
            [[3], [1], [1], [1], [1], [1], [1], [1], [1], [1], [1], [1], [1], [3]],
            [[3], [1], [1], [1], [1], [1], [1], [1], [1], [1], [1], [1], [1], [3]],
            [[3], [3], [3], [3], [3], [3], [4], [4], [3], [3], [3], [3], [3], [3]]
        ]
    }
}